NO main.c
SO main.c
WE main.c
EA main.c

F 00,000,0 
C 00,000,0 


111111111111111
100001000000001
10000111110111111111111111
10000011000000000000010001
1000000000000N000000000001
10000011000000000000010001
11111111111111111111111111
