NO main.c
SO main.c
WE main.c
EA main.c

F 77,92,53
C 163,208,230 


111111111111111
100001000000001
10000111110111111111111111
10000011000000000000010001
10000000000000000000000001
1000001100000W000000010001
11111111111111111111111111
