NO ./xpm/no.xpm
SO ./xpm/so.xpm
WE ./xpm/we.xpm
EA ./xpm/ea.xpm

F 77,92,53
C 163,208,230


111111111111111
100001000000001
10000111110111111111111111
10000011000000000000010001
10000000000000000000000001
1000001100000E000000010001
11111111111111111111111111
