NO ./xpm/no.xpm
SO ./xpm/so.xpm
WE ./xpm/we.xpm
EA ./xpm/ea.xpm

F 77,92,53
C 163,208,230

11111111111
10000000001
10000000001
10000000001
10000000001
10000000001
10000100001
10000100001
10000100001
10000100001
10000100001
10000000001
10000000001
10000000001
10000000001
10000000001
10000000001
10000N00001
10000000001
10000000001
10000000001
10000000001
10000000001
10000000001
10000000001
10000000001
10000000001
10000000001
11111111111
