NO ./xpm/no1.xpm
SO ./xpm/so1.xpm
WE ./xpm/we1.xpm
EA ./xpm/osabir.xpm

F 225,92,53
C 163,208,230



1111
10E1
1111
