WE ./xpm/we1.xpm
SO ./xpm/so1.xpm
NO ./xpm/no1.xpm
EA ./xpm/ea1.xpm

F 100,100,100
C 163,208,230


        111111111111111111111111
        1000000000110000000100001
        1011000001110000000E10001
        1001000000000000000000001                    
111111111011000001110000000000001
100000000011000001110111110111111
11110111111111011100000010001 
11110111111111011101010010001
11000000110101011100000010001
10000000000000000000000010001
10000000000000001101010010001
11000001110101011111011110001
1111011 1110101 101111010001
1111111 1111111 111111111111