NO ./xpm/no1.xpm
SO ./xpm/so1.xpm
WE ./xpm/osabir.xpm
EA ./xpm/ea1.xpm

F 77,92,53
C 163,208,230

11111111111
10000000001
10000000001
10000000001
10000W00001
10000000001
10000100001
10000100001
10000100001
10000100001
10000100001
10000000001
10000000001
10000000001
10000000001
10000000001
10000000001
10000000001
10000000001
10000000001
10000000001
10011100001
10000000001
10000000001
10000000001
10000000001
10000000001
10000000001
11111111111
